NO ./textures/Brick.xpm
SO ./textures/Tile.xpm
WE ./textures/Metal.xpm
EA ./textures/Wood.xpm

F +220,100,0
C +225,30, +0


        1111111111111111111111111
        1000000000110000000000001
        1011000001110000000000001
        100100000000000000000001
1111111110110000011100000000000E1
10000000001100000111011111111111
11110111111111011100000010001
11110111111111011101010010001    
11111111111111111111111111111
11111111111111111111111111111
11000000110101011100000010001111
10000000000000001100000010001
10000000000000001101010010001
1100000111010101111101111010111
11110111 1110101 10111101001
11111111 1111111 111111111111




